itsu|O一|uno
ichi|O一|uno
hito-tsu|K一つ|uno
ni|O二,O日,O耳|due,giorno/sole,orecchio
ji|O二,O耳,O字|due,orecchio,carattere
futa-tsu|K二つ|due
san|O三,O山|tre,montagna
mit-tsu|K三つ|tre
shi|O四,O子,O糸|quattro,bambino,filo
yon|K四|quattro
yot-tsu|K四つ|quattro
go|O五|cinque
itsu-tsu|K四つ|cinque
roku|O六|sei
mut-tsu|K六つ|sei
shichi|O七|sette
nana-tsu|K七つ|sette
hachi|O八|otto
yat-tsu|K八つ|otto
ku|O九|nove
kyū|O九,O休|nove,riposare
kokono-tsu|K九つ|nove
jū|O十|dieci
tō|K十|dieci
hyaku|O百|cento
momo|K百|cento
sen|O千,O川,O先|mille,fiume,precedente
chi|K千|mille
jō|O上|sopra
ue|K上|sopra
ka|O下,O花,O火|sotto,fiore,fuoco
shita|K下|sotto
sa|O左|sinistra
hidari|K左|sinistra
yū|O右,K夕|destra,sera
u|O右,O雨|destra,pioggia
migi|K右|destra
chū|O中,O虫|dentro/in mezzo,insetto
naka|K中|dentro/in mezzo
dai|O大|grande
tai|O大|grande
ō-kii|K大きい|grande
shō|O小|piccolo
chii-sai|K小さい|piccolo
gatsu|O月|luna
getsu|O月|luna
tsuki|K月|luna
nichi|O日|sole/giorno
hi|K日,K火|sole/giorno,fuoco
nen|O年|anno
toshi|K年|anno
sō|O早,O草|presto,erba
haya-i|K早い|presto
moku|O木|albero
boku|O木|albero
ki|K木,O気|albero,spirito
rin|O林|bosco
hayashi|K林|bosco
shin|O森|foresta
mori|K森|foresta
yama|K山|montagna
kawa|K川|fiume
do|O土|suolo
tsuchi|K土|suolo
kū|O空|cielo
sora|K空|cielo
den|O田|campo di riso
ta|K田|campo di riso
ten|O天|paradiso/cielo
ama|K天|paradiso/cielo
sei|O生,O正,O青|vita,correggere,blu
i-kiru|K生きる|vivere
u-mareru|K生まれる|nascere
hana|K花|fiore
kusa|K草|erba
mushi|K虫|insetto
ken|O見,O犬|vedere,cane
jin|O人|persona
nin|O人|persona
hito|K人|persona
mei|O名|nome
myō|O名|nome
na|K名|nome
jo|O女|femmina
nyo|O女|femmina
on'na|K女|femmina
dan|O男|maschio
nan|O男|maschio
otoko|K男|maschio
shi|O子|bambino
su|O子|bambino
ko|K子|bambino
me|K目|occhio
mimi|K耳|orecchio
kō|O口,O校|bocca,scuola
kuchi|K口|bocca
shu|O手|mano
te|K手|mano	
soku|O足|piede/gamba
ashi|K足|piede/gamba
mi-ru|K見る|vedere
on|O音|suono
ne|O音|suono
oto|K音|suono
riki|O力|potenza
ryoku|O力|potenza
chikara|K力|potenza
ke|O気|spirito
iki|K気|spirito
en|O円|yen
maru|K円|cerchio
nyū|O入|entrare
hai-ru|K入る|entrare
i-ru|K入る|entrare
shutsu|O出|uscire
de-ru|K出る|uscire
ritsu|O立|stare in piedi
ta-tsu|K立つ|stare in piedi
yasu-mu|K休む|riposare
saki|K先|precedente
seki|O夕,O赤,O石|sera,rosso,pietra
hon|O本|libro
moto|K本|libro
bun|O文|scrivere
fumi|K文|scrivere
azana|K字|carattere
gaku|O学|studio
mana-bu|K学ぶ|studiare
kase|K校|scuola	
son|O村|villaggio
mura|K村|villaggio
chō|O町|città
machi|K町|città
tada-shii|K正しい|correggere	
sui|O水acqua
mizu|K水|acqua
gyoku|O玉|gemma
tama|K玉|gemma
ō|K王|re
ishi|K石|pietra	
chiku|O竹|bambù
take|K竹|bambù
ito|K糸|filo
kai|K貝|conchiglia
sha|O車|veicolo con le ruote
kuruma|K車|veicolo con le ruote
kin|O金|oro/metallo prezioso
kane|K金|oro/metallo prezioso
ame|K雨|pioggia
aka|K赤|rosso
ao|K青|blu
haku|O白|bianco	
shiro|K白|bianco